# ##########
 P        O#
###       ##
  #   X   #
  #    X  ##
  #   X    ### ##
###            O#
#          ######
############
